ekkaiaenoia	ekka 
kar72	kar 
eruiskawaii	eru 
peeku	watashiiit	eric
smarthardyz	smart 
watashiii	watashi 	akl
bop	shake
poolnoodle	poolnoober
himemiya	himeiya
zeal_kido	zealkido
atsui	atsui_	cakey
shortcake	alice
bakeman	eggsdee
fumiii	vnsoul
ayroby	kar_4
gabrielarobin	spyair	milar
ilmatar	pantsudestroyer	kawasumiayako
shiinamahiru	yourslavesz
mahirushiina	yerardi
kezzy	fujimasakura
star_driver	stardriver
lilyholic	chelly
anonimus_opinion	anonimusopinion
szafa	chata
edwardd	edward 
konsumenci	konsu 
claydoll1091	claydoll 
renzou	ren 
zippy	stormross
poison205	hanato	yurinekurosawa
transfer	isischan
ksante4700hp	noru
vsai	sai
fortnayt	sewim
gyroinmobile	hitoribocchi
bella	isabella	xieliann
x_____________	gw13
mitsorubi	mitsurobi